+----+---------+-----------------------+
|    |         |                       |
|  --+         |                       |
|    |    |    +-----    +--------+    |
+--  |    |    |         |        |    |
|    |    |              |   |    |    |
|  --+    |              |   +----+----+
|    |    +-------+      |        |    |
+--  |            |      |        |    |
|    |            |      +----    |    |
|  --+    ---+    |                    |
|    |       |    |                    |
|    |       |    +------   |          |
|    +-------+    |         |          |
|                 |         |          |
+-----------------+---------+----------+